Mending Poultice	Forest Herb x2, Hagshroom x1	First Things First
Empty Jar	Clay x3, Campfire Ember x1	First Things First
Unveiling Powder	Hagshroom x1, Seeker Vine x2, Impeye Nut x1	First Things First
Hearthseed	Impeye Nut x1, Flower Petal x2	First Things First
Snap Trap	Impeye Nut x1, Wickerwork x1	First Things First
Soporific Morsel	Soporific Potion x1, Meaty Morsel x1	First Things First
Bait Stick	Toxic Thistle x1, Twig x1, Meaty Morsel x1	Part 1
Smoke Pellet	Frog Slime x2, Forest Herb x1, Clay x3	Part 1
Digestive Tablet	Snail Shell x3, Eye of Newt x1, Goblin Snot x1	Part 1
Protective Talisman	Wicked Gemstone x1, Magic Paste x1, Wickerwork x2	The Bear
Snagvine	Seeker Vine x3, Sewing Kit x1	Part 1
Cinderbox	Campfire Ember x1, Rodent Lard x1, Firefly x3	Part 1
Snackrifice	Soporific Potion x1, Roast Beast x1, Magic Paste x1	The Leech
Royal Incense	Smoke Pellet x1, Witch Spice x1, Soporific Potion x1	The Bear
Shiny Lure	Shiny Stone x1, Firefly x2, Wickerwork x1	Part 2
Glitter Bomb	Empty Jar x1, Soot Sprite x2, Flower Petal x3	The Snake
Purification Water	Ghostly Ectoplasm x1, Jar of Water x3, Forest Herb x2	The Rat
Skeleton Key	Grave Bone x3, Mummified Head x1, Skeeter Snoot x1	Part 2
Key to my Heart	Love Potion x1, Skeleton Key x1	The Fish
Pluckpocket	Grave Bone x1, Crab Claw x1, Pickpocket's Glove x1	Part 2
Acidic Unguent	Wyrd Water x1, Algae x4, Potion of Blight x1	The Rat
Tidal Tincture	Wyrd Water x1, Skipper Scale x2, Soothing Rune x1	The Fish
Fishing Line	Reedy Twine x1, Iron Nail x1, Hopper Leg x1	Part 2
Crab Trap	Barnacle x1, Wickerwork x2	Part 2
Puzzle Box	Changeling Root x2, Iron Nail x2, Seashell x1	The Ram
Cat Treat	Fish x1, Jar of Milk x2	Part 2
Feline Curio	Cat Treat x1, Witch Spice x1, Stuffed Birb x1	The Cat
Prestidigitation Deck	Glitter Bomb x1, Shiny Lure x1, Skipper Scale x2	The Ram
Restorative Idol	Mandrake Root x2, Necromantic Charm x1, Mending Poultice x2	Part 2
Arachnicide	Soot Sprite x1, Potion of Blight x1, Lethe Cap x3	Part 2
Spirit Salts	Embalming Salts x3, Unveiling Powder x1	The Leech
Soothing Rune	Spirit Salts x1, Soporific Potion x1, Cobblestone x3	Part 2
Exorcism Charm	Wickerwork x1, Black Rose x1, Bat Wing x2	Part 2
Bottled Despair	Spectral Tears x1, Mandrake Root x3, Wyrd Water x1	The Ram
Dreadful Doll	Grain x3, Hopper Leg x3, Sewing Kit x1	Part 1
Haunted Mannequin	Dreadful Doll x1, Mummified Head x1, Ghostly Ectoplasm x1	The Ram
Spirit Board	Grave Bone x1, Necromantic Charm x1, Wicked Gemstone x1	The Rat
Melting Pot	Cinderbox x1, Spicy Pepper x2, Red Feather x2	Part 3
Glamour	Mimic's Toe x1, Totemic Moondrop x1, Foggy Perfume x1	The Hawk
Truth Serum	Unveiling Powder x1, Crowsfoot x1, Chilled Mushroom x3	The Stag
Floral Wreath	Lazy Grass x2, Wickerwork x1, Rainbow Roll x1	The Hawk
Snow Snare	Ice Berry x3, Reedy Twine x2, Iron Nail x2	Part 3
Frozen Treat	Soporific Morsel x1, Frostling Snow x1, Chilled Mushroom x3	Part 3
Touch of Cold	Frostling Snow x2, Bottled Despair x1, Metamorphosis Elixir x1	The Stag
Goat Perch	Cobblestone x8, Magic Paste x1, Shiny Lure x1	The Stag
Avian Lexicon	Red Feather x2, Stuffed Birb x1, Blood x1	The Wolf
Wickerwork	Reedy Twine x1, Twig x2	First Things First
Soporific Potion	Lethe Cap x2, Jar of Water x1, Impeye Nut x1	First Things First
Magic Paste	Dragonfly Wing x1, Fairy Dust x1, Jar of Milk x1	Part 1
Wyrd Water	Jar of Water x1, Hagshroom x2, Bug Ichor x2	The Ox
Apothecary Humors	Blood x3, Bug Ichor x3, Frog Slime x3	Part 1
Necromantic Charm	Pumpkin Jack Bone x1, Blood x2, Wickerwork x1	The Leech
Sewing Kit	Reedy Twine x2, Skeeter Snoot x1	Part 1
Witch Spice	Hagshroom x2, Impeye Nut x2, Forest Herb x2	Part 1
Roast Beast	Meaty Morsel x4, Witch Spice x1, Campfire Ember x3	Part 1
Dough	Egg x3, Grain x5, Jar of Milk x2	The Ox
Humble Pie	Roast Beast x1, Dough x1, Crowsfoot x2	The Ox
Rainbow Roll	Impeye Nut x2, Dough x1, Glitter Bomb x1	The Cat
Moonlight Globe	Shiny Stone x2, Totemic Moondrop x1, Glitter Bomb x1	The Snake
Wicked Gemstone	Campfire Ember x3, Shiny Stone x4, Dog Hair x1	The Bear
Metamorphosis Elixir	Dryad Fruit x1, Bug Ichor x3, Changeling Root x2	The Bear
Growth Potion	Apothecary Humors x1, Magic Paste x1, Flower Petal x3	The Ox
Potion of Blight	Toxic Thistle x3, Lazy Grass x3, Eye of Newt x1	The Ox
Stuffed Birb	Pigeon's Beak x1, Mimic's Toe x1, Blue Feather x2	The Cat
Allergenic Potpourri	Dog Hair x1, Cat Hairball x1, Rat Tail x1	The Fish
Foggy Perfume	Smoke Pellet x1, Witch Spice x2, Ghostly Ectoplasm x1	The Hawk
Oceanic Oil	Barnacle x4, Algae x10, Deep One x1	The Fish
Love Potion	Black Rose x5, Dryad Fruit x1, Oceanic Oil x1	The Fish
Alchemical Alloy	Fox Fur x1, Gold Coins x5, Puzzle Box x1	Part 3
Silver Bullet	Alchemical Alloy x1, Melting Pot x1, Moonlight Globe x1	The Wolf
Porcine Effigy	Dough x1, Wickerwork x4, Haunted Mannequin x1	The Hog
Big Stick	Grave Bone x4, Twig x5, Iron Nail x6	The Hog
Magnum Browbeater	Barnacle x5, Wicked Gemstone x1, Big Stick x1	The Hog
Lashmaster 2000	Rat Tail x3, Skeeter Snoot x2, Pumpkin Jack Bone x1	The Hog
Lucky Strop	Rabbit Foot x3, Goblin Snot x1, Gnome Hat x1	The Hog
Magi-Sharp XL	Turkey Gizzardstone x2, Cobblestone x5, Lucky Strop x1	The Hog